33333333333333333333333333333333333333333333333333333333333333333333333333333333333333333333333333333333333333333333333333333333333333333333333
3                                                                                                                                             3
3                                                                                                                                             3
3                                                                                                                                             3
3                                                                                                                                             3
3                                                                                                                                             3
3                                                                                                                                             3
3                                                                                                                                             3
3                                                                                                                                  4          3
3                                                                                                                                  4          3
3                                                                                                                      1           4          3
3                                                                                                                     11           4          3
3                                                                                                                    111           4          3
3                                                                                                                   1111           4          3
3                                  1  1                                                                            11111           4          3
3          222 222      *         11  11                                                                          111111           4          3
3                                111  111                                                                        1111111           4          3
311111111111111111111111111111111111  111111111111111111111111111111111111111111111111111111111111111111111111111111111111111111111111111111113
31111111111111111111111111111111111100111111111111111111111111111111111111111111111111111111111111111111111111111111111111111111111111111111113
33333333333333333333333333333333333333333333333333333333333333333333333333333333333333333333333333333333333333333333333333333333333333333333333